{
    "enemyPath"     : ":/paths/path_3.txt" ,
    "gold"   		: 300,
    "waves"         : [[3, 0, 0, 0, 0, 0, 0],
                       [4, 1, 0, 0, 0, 0, 0],
                       [5, 2, 0, 0, 0, 0, 0],
                       [6, 3, 0, 0, 0, 0, 0],
                       [0, 0, 0, 0, 3, 0, 0],
                       [1, 7, 0, 0, 4, 0, 0],
                       [0, 4, 4, 0, 2, 1, 0],
                       [0, 0, 0, 0, 4, 3, 0],
                       [0, 0, 0, 0, 5, 4, 1]]
}
