{
    "enemyPath"     : ":/paths/path_2.txt" ,
    "gold"   		: 320,
    "waves"         : [[4, 0, 0, 0, 0, 0, 0],
                       [5, 1, 0, 0, 0, 0, 0],
                       [6, 4, 0, 0, 0, 0, 0],
                       [2, 5, 2, 0, 0, 0, 0],
                       [0, 0, 1, 0, 4, 0, 0],
                       [0, 0, 0, 0, 6, 1, 0],
                       [1, 8, 6, 0, 4, 2, 0]]
}
